/>--\        
|   |  /-<--\
| /-+--+-\  |
| | |  | v  |
\-+-/  \-+--/
  \------/   